S B B F F
B F B B B
B B F B B
B B B F B
F F B B E